{
  "levels": [
    {
      "id": 0,
      "name": "Tutorial",
      "background": "assets/Backdrops/tutorial.png",
      "best_time": 37.133,
      "map_data": [
        "..................................................................................................................................................................................................................",
        "..................................................................................................................................................................................................................",
        "..................................................................................................................................................................................................................",
        "..................................................................................................................................................................................................................",
        "..................................................................................................................................................................................................................",
        "..................................................................................................................................................................................................................",
        "..................................................................................................................................................................................................................",
        "..................................................................................................................................................................................................................",
        "..................................................................................................................................................................................................................",
        "..................................................................................................................................................................................................................",
        "..................................................................................................................................................................................................................",
        ".........................................................................................................................(@@@@@@@@@@@@@).......6..................................................................",
        "...................4.....................................................................................................r\u00e9uuuuuuuuuuu\u00e8l.........................................................................(",
        "......................................................................................................5..................rl...........rl.........................................................................r",
        "..3.............................(@@)..................................(@)................................................rl.........P.rl.........................................................................r",
        "................................r##l...................................v.................................................rl........(@)[].........................................................................r",
        "................................r##l.....................................................................................[]......1...D...........................................................................r",
        ")...............................[uu].....................................................................................d.......2...D...........F...............................................................r",
        "l..................(@@@@).................C..............................................................................d......(@@@@@@@@@@@@@@@@@@@@@@@@@@@@@@@@@@@@@@@@@@@@@@@@@@@@@@@@@@@@@@@@@@@@@@@@@@@@@@@@R",
        "l..................r####L@@@@@@@@@@@@@@@@@@@@@@)................C..............C..............C..........................d............r###########################################################################",
        "l1.....(@@@@)......r###########################L@@)...G...(@@@@@@@@@@@@@@@@@@@@@@@@@@)...(@@@@@@@@@)...B.......p.........d..........P.r###########################################################################",
        "l2.....r####L@@@@@@R##############################L@@@@@@@R##########################lSSSr#########L@@@@@@@@@@@@@@@@@@@@@@@@@@@@@@@@@@R###########################################################################",
        "L@@@@@@R##########################################################################################################################################################################################################"
      ]
    },
    {
      "id": 1,
      "name": "Deep Dungeon",
      "background": "assets/Backdrops/tutorial.png",
      "best_time": null,
      "map_data": [
        "........................................................................",
        "....................(@@)...............................................",
        "........................................................................",
        "L@@@@@@@@@@@@@@@@@@@@@@@@@@@@@@@@@@@@@@@@@@@@@@@@@@@@@@@@@@@@@@@@@@@@@@@R"
      ]
    }
  ]
}